NO textures/1.png
SO textures/2.png
WE textures/3.png
EA textures/4.png

F 34,139,34
C 173,216,230

111111111111111
110000000000001
110000000000001
110000000000001
110000000000E01
111111111111101111111111
110000000000011110000001
110000000000000000000001
110000000000000000000001
110000000000001111111111
111111111111111
110000000000001
110000000000001
110000000000001
110000000000001
111111111111111
