NO textures/1.png
SO textures/2.png
WE textures/3.png
EA textures/4.png

F 34,139,34
C 173,216,230

111111111111111111
100000000000000001
100000000000000001
100000000111111001
100000000000000001
100000000001111111
100000001000000001
1000000000E0000001
100000000000000001
100000000000000001
100000000011111001
100000000000000001
100000000000000001
111111111111111111