NO texture/1.png
SO texture/2.png
WE texture/3.png
EA texture/5.png

F 220,100,0
C 225,30,0

1111
1E001
1001
1H111