NO textures/1.png
SO textures/2.png
WE textures/3.png
EA textures/4.png

F 34,139,34
C 173,216,230

111111111111111
110000000000001
110000000000001
110000000000001
110000000000001
110000000000001
110000000000001
110000000000001
110000000000001
110000000000001
11110000W00001
110000000000001
110000000000001
110000000000001
110000000000001
110000000000001
110000000000001
111111111111111